광역시도,시도,구시군,선거인수,투표수,당선 정당,2등 정당,당선자 득표수,2등 득표수,계,무효투표수,기권수
강원도,강릉시,강릉시,184371,122855,무소속,더불어민주당,49618,47088,121474,1381,61516
강원도,동해시태백시삼척시정선군,동해시,76543,49535,미래통합당,더불어민주당,26690,20493,48958,577,27008
강원도,동해시태백시삼척시정선군,삼척시,58270,39729,미래통합당,더불어민주당,20685,17373,39279,450,18541
강원도,동해시태백시삼척시정선군,정선군,33231,21795,미래통합당,더불어민주당,11147,9632,21464,331,11436
강원도,동해시태백시삼척시정선군,태백시,37712,24171,미래통합당,더불어민주당,13082,10029,23885,286,13541
강원도,속초시인제군고성군양양군,고성군,24504,17865,미래통합당,더불어민주당,9540,7325,17430,435,6639
강원도,속초시인제군고성군양양군,속초시,70022,43970,미래통합당,더불어민주당,22665,19540,43476,494,26052
강원도,속초시인제군고성군양양군,양양군,24916,16941,미래통합당,더불어민주당,9380,6919,16707,234,7975
강원도,속초시인제군고성군양양군,인제군,27135,18269,미래통합당,더불어민주당,8603,8419,17872,397,8866
강원도,원주시갑,원주시,152303,94018,더불어민주당,미래통합당,45224,38299,93116,902,58285
강원도,원주시을,원주시,141827,91625,더불어민주당,미래통합당,48772,39089,90509,1116,50202
강원도,춘천시철원군화천군양구군갑,춘천시,192353,131779,더불어민주당,미래통합당,66932,57298,130410,1369,60574
강원도,춘천시철원군화천군양구군을,양구군,18960,13158,미래통합당,더불어민주당,6441,6278,12909,249,5802
강원도,춘천시철원군화천군양구군을,철원군,38883,24994,미래통합당,더불어민주당,13966,10092,24416,578,13889
강원도,춘천시철원군화천군양구군을,춘천시,46191,31338,더불어민주당,미래통합당,15389,14998,30827,511,14853
강원도,춘천시철원군화천군양구군을,화천군,21425,14942,미래통합당,더불어민주당,7678,6593,14579,363,6483
강원도,홍천군횡성군영월군평창군,영월군,35114,23548,미래통합당,더불어민주당,13205,9021,23274,274,11566
강원도,홍천군횡성군영월군평창군,평창군,37586,24890,미래통합당,더불어민주당,11994,11864,24621,269,12696
강원도,홍천군횡성군영월군평창군,홍천군,60611,39858,미래통합당,더불어민주당,16620,12367,39054,804,20753
강원도,홍천군횡성군영월군평창군,횡성군,41381,28911,미래통합당,더불어민주당,14156,10982,28235,676,12470
경기도,고양시갑,고양시덕양구,217323,144830,정의당,미래통합당,56516,47003,143491,1339,72493
경기도,고양시병,고양시일산동구,224741,149247,더불어민주당,미래통합당,80068,65981,147541,1706,75494
경기도,고양시을,고양시덕양구,227546,155449,더불어민주당,미래통합당,80739,55032,153866,1583,72097
경기도,고양시정,고양시일산서구,235439,162225,더불어민주당,미래통합당,85943,72188,160869,1356,73214
경기도,광명시갑,광명시,134409,91285,더불어민주당,미래통합당,43019,33380,90250,1035,43124
경기도,광명시을,광명시,131277,91602,더불어민주당,미래통합당,58130,27671,90691,911,39675
경기도,광주시갑,광주시,156890,95752,더불어민주당,미래통합당,53221,40469,94784,968,61138
경기도,광주시을,광주시,155614,93174,더불어민주당,미래통합당,52468,38910,92242,932,62440
경기도,구리시,구리시,168689,111590,더불어민주당,미래통합당,64668,43456,110263,1327,57099
경기도,군포시,군포시,232665,160765,더불어민주당,미래통합당,91256,64167,158934,1831,71900
경기도,김포시갑,김포시,165807,111816,더불어민주당,미래통합당,58613,42660,110829,987,53991
경기도,김포시을,김포시,187295,118595,더불어민주당,미래통합당,63193,52200,117389,1206,68700
경기도,남양주시갑,남양주시,169352,104185,더불어민주당,미래통합당,59779,39318,103144,1041,65167
경기도,남양주시병,남양주시,213448,144575,더불어민주당,미래통합당,71776,67490,143323,1252,68873
경기도,남양주시을,남양주시,194104,117404,더불어민주당,미래통합당,68660,36526,116208,1196,76700
경기도,동두천시연천군,동두천시,80677,47856,미래통합당,더불어민주당,24305,22325,47234,622,32821
경기도,동두천시연천군,연천군,38284,25577,미래통합당,더불어민주당,14472,10237,25097,480,12707
경기도,부천시갑,부천시,138380,82208,더불어민주당,미래통합당,48002,29266,81118,1090,56172
경기도,부천시병,부천시,201857,129904,더불어민주당,미래통합당,77577,41642,128105,1799,71953
경기도,부천시을,부천시,220045,148949,더불어민주당,미래통합당,80889,58341,147319,1630,71096
경기도,부천시정,부천시,150459,88552,더불어민주당,미래통합당,49552,32094,87322,1230,61907
경기도,성남시분당구갑,성남시분당구,208104,157419,미래통합당,더불어민주당,78134,77006,156051,1368,50685
경기도,성남시분당구을,성남시분당구,195239,143734,더불어민주당,미래통합당,68387,64342,142645,1089,51505
경기도,성남시수정구,성남시수정구,205299,129551,더불어민주당,미래통합당,76830,45617,127383,2168,75748
경기도,성남시중원구,성남시중원구,192279,122114,더불어민주당,미래통합당,65947,50315,120736,1378,70165
경기도,수원시갑,수원시장안구,197868,131560,더불어민주당,미래통합당,76875,51428,129921,1639,66308
경기도,수원시무,수원시권선구,229748,150216,더불어민주당,미래통합당,82002,56793,148505,1711,79532
경기도,수원시병,수원시팔달구,154623,96070,더불어민주당,미래통합당,50369,40374,94903,1167,58553
경기도,수원시을,수원시권선구,213294,140857,더불어민주당,미래통합당,84500,53334,139240,1617,72437
경기도,수원시정,수원시영통구,201639,139932,더불어민주당,미래통합당,79557,52585,138535,1397,61707
경기도,시흥시갑,시흥시,205939,134026,더불어민주당,미래통합당,68653,59595,132745,1281,71913
경기도,시흥시을,시흥시,185880,104604,더불어민주당,미래통합당,69270,32700,103351,1253,81276
경기도,안산시단원구갑,안산시단원구,132915,76381,더불어민주당,미래통합당,42009,31086,75359,1022,56534
경기도,안산시단원구을,안산시단원구,127185,83176,더불어민주당,미래통합당,42150,38497,82123,1053,44009
경기도,안산시상록구갑,안산시상록구,167327,101953,더불어민주당,미래통합당,59021,38367,100791,1162,65374
경기도,안산시상록구을,안산시상록구,129225,76660,더불어민주당,미래통합당,43599,30747,75464,1196,52565
경기도,안성시,안성시,155021,98475,더불어민주당,미래통합당,49721,45554,96647,1828,56546
경기도,안양시동안구갑,안양시동안구,145827,102910,더불어민주당,미래통합당,56345,40490,101821,1089,42917
경기도,안양시동안구을,안양시동안구,122068,92555,더불어민주당,미래통합당,49736,38327,91842,713,29513
경기도,안양시만안구,안양시만안구,210881,141903,더불어민주당,미래통합당,75266,59438,140399,1504,68978
경기도,양주시,양주시,184804,112865,더불어민주당,미래통합당,69905,40414,111589,1276,71939
경기도,여주시양평군,양평군,101727,69732,미래통합당,더불어민주당,39129,26761,68987,745,31995
경기도,여주시양평군,여주시,95778,60124,미래통합당,더불어민주당,31446,24813,59381,743,35654
경기도,오산시,오산시,182471,110578,더불어민주당,미래통합당,61926,44834,109183,1395,71893
경기도,용인시갑,용인시처인구,212846,133134,미래통합당,더불어민주당,69826,60357,131392,1742,79712
경기도,용인시병,용인시수지구,225216,165398,더불어민주당,미래통합당,84492,78562,163872,1526,59818
경기도,용인시을,용인시기흥구,219373,150616,더불어민주당,미래통합당,89697,57671,149278,1338,68757
경기도,용인시정,용인시기흥구,206940,150335,더불어민주당,미래통합당,79794,65358,149247,1088,56605
경기도,의왕시과천시,과천시,48899,37489,미래통합당,더불어민주당,17317,15140,37152,337,11410
경기도,의왕시과천시,의왕시,139682,99587,더불어민주당,미래통합당,43798,34239,98693,894,40095
경기도,의정부시갑,의정부시,178374,104773,더불어민주당,미래통합당,54806,38644,103345,1428,73601
경기도,의정부시을,의정부시,207183,129338,더불어민주당,미래통합당,71573,49640,127836,1502,77845
경기도,이천시,이천시,179016,110100,미래통합당,더불어민주당,56544,49682,108749,1351,68916
경기도,파주시갑,파주시,219983,141143,더불어민주당,미래통합당,85058,52122,139597,1546,78840
경기도,파주시을,파주시,151068,90578,더불어민주당,미래통합당,48569,39588,89381,1197,60490
경기도,평택시갑,평택시,213863,126228,더불어민주당,미래통합당,62564,59063,124573,1655,87635
경기도,평택시을,평택시,214797,126373,미래통합당,더불어민주당,59491,57540,124786,1587,88424
경기도,포천시가평군,가평군,55094,35180,미래통합당,더불어민주당,18968,14624,34552,628,19914
경기도,포천시가평군,포천시,128897,75631,더불어민주당,미래통합당,36251,35803,74427,1204,53266
경기도,하남시,하남시,227800,152136,더불어민주당,미래통합당,76572,50141,150811,1325,75664
경기도,화성시갑,화성시,199428,119449,더불어민주당,미래통합당,58689,52291,118198,1251,79979
경기도,화성시병,화성시,219651,139281,더불어민주당,미래통합당,88793,47377,137769,1512,80370
경기도,화성시을,화성시,224298,154360,더불어민주당,미래통합당,98612,52802,152805,1555,69938
경상남도,거제시,거제시,197349,130531,미래통합당,더불어민주당,65746,49136,129183,1348,66818
경상남도,김해시갑,김해시,219863,139008,더불어민주당,미래통합당,70094,61890,137266,1742,80855
경상남도,김해시을,김해시,223167,145744,더불어민주당,미래통합당,71634,60003,144200,1544,77423
경상남도,밀양시의령군함안군창녕군,밀양시,93329,61581,미래통합당,더불어민주당,40844,18813,60635,946,31748
경상남도,밀양시의령군함안군창녕군,의령군,24740,17376,미래통합당,더불어민주당,11747,4710,16876,500,7364
경상남도,밀양시의령군함안군창녕군,창녕군,55177,37340,미래통합당,더불어민주당,26688,9415,36685,655,17837
경상남도,밀양시의령군함안군창녕군,함안군,55881,36770,미래통합당,더불어민주당,22931,12560,36109,661,19111
경상남도,사천시남해군하동군,남해군,39430,28232,미래통합당,더불어민주당,18921,8222,27649,583,11198
경상남도,사천시남해군하동군,사천시,94821,63497,미래통합당,더불어민주당,34981,25530,62472,1025,31324
경상남도,사천시남해군하동군,하동군,41667,30787,미래통합당,더불어민주당,17718,11460,30062,725,10880
경상남도,산청군함양군거창군합천군,거창군,53599,38976,무소속,미래통합당,17755,13147,38307,669,14623
경상남도,산청군함양군거창군합천군,산청군,32103,23297,무소속,미래통합당,9136,8411,22815,482,8806
경상남도,산청군함양군거창군합천군,함양군,35175,25500,무소속,미래통합당,10635,7843,25019,481,9675
경상남도,산청군함양군거창군합천군,합천군,41197,29891,미래통합당,무소속,12660,11597,29198,693,11306
경상남도,양산시갑,양산시,153416,101497,미래통합당,더불어민주당,57301,42260,100529,968,51919
경상남도,양산시을,양산시,135524,91238,더불어민주당,미래통합당,44218,42695,90335,903,44286
경상남도,진주시갑,진주시,160833,111197,미래통합당,더불어민주당,60112,42241,109781,1416,49636
경상남도,진주시을,진주시,129775,86523,미래통합당,더불어민주당,50217,28779,85074,1449,43252
경상남도,창원시마산합포구,창원시마산합포구,152336,104034,미래통합당,더불어민주당,64706,35124,102761,1273,48302
경상남도,창원시마산회원구,창원시마산회원구,164936,115805,미래통합당,더불어민주당,64581,48018,114454,1351,49131
경상남도,창원시성산구,창원시성산구,182830,131968,미래통합당,정의당,61782,45567,130600,1368,50862
경상남도,창원시의창구,창원시의창구,221849,152046,미래통합당,더불어민주당,88718,55153,150248,1798,69803
경상남도,창원시진해구,창원시진해구,155692,105737,미래통합당,더불어민주당,52000,50595,103542,2195,49955
경상남도,통영시고성군,고성군,45880,31352,미래통합당,더불어민주당,19753,10296,30732,620,14528
경상남도,통영시고성군,통영시,109768,73732,미래통합당,더불어민주당,40561,29939,72638,1094,36036
경상북도,경산시,경산시,224371,141092,미래통합당,더불어민주당,88684,37810,139095,1997,83279
경상북도,경주시,경주시,221512,148761,미래통합당,무소속,77102,29076,146373,2388,72751
경상북도,고령군성주군칠곡군,고령군,28891,19452,미래통합당,더불어민주당,13112,3282,19073,379,9439
경상북도,고령군성주군칠곡군,성주군,39925,27228,미래통합당,더불어민주당,16986,4941,26717,511,12697
경상북도,고령군성주군칠곡군,칠곡군,96828,59069,미래통합당,더불어민주당,35138,16765,58236,833,37759
경상북도,구미시갑,구미시,177679,113587,미래통합당,더불어민주당,73339,35324,111834,1753,64092
경상북도,구미시을,구미시,162426,98212,미래통합당,더불어민주당,54457,34442,96495,1717,64214
경상북도,군위군의성군청송군영덕군,군위군,22147,16518,미래통합당,더불어민주당,13213,2623,16207,311,5629
경상북도,군위군의성군청송군영덕군,영덕군,33560,22984,미래통합당,더불어민주당,16996,5253,22551,433,10576
경상북도,군위군의성군청송군영덕군,의성군,48524,35889,미래통합당,더불어민주당,28789,5769,35205,684,12635
경상북도,군위군의성군청송군영덕군,청송군,23391,16560,미래통합당,더불어민주당,12534,3424,16233,327,6831
경상북도,김천시,김천시,120702,81909,미래통합당,더불어민주당,59993,16914,80505,1404,38793
경상북도,상주시문경시,문경시,63102,42331,미래통합당,무소속,23394,11049,41478,853,20771
경상북도,상주시문경시,상주시,87635,61158,미래통합당,더불어민주당,42164,11769,59691,1467,26477
경상북도,안동시예천군,안동시,137615,94479,미래통합당,더불어민주당,40094,25325,92893,1586,43136
경상북도,안동시예천군,예천군,47268,31180,미래통합당,더불어민주당,18089,6968,30621,559,16088
경상북도,영주시영양군봉화군울진군,봉화군,28998,20668,미래통합당,무소속,11718,4494,20300,368,8330
경상북도,영주시영양군봉화군울진군,영양군,15371,11156,미래통합당,무소속,6866,1988,10942,214,4215
경상북도,영주시영양군봉화군울진군,영주시,91153,62390,미래통합당,무소속,28625,17337,61421,969,28763
경상북도,영주시영양군봉화군울진군,울진군,43086,29937,미래통합당,더불어민주당,20817,5209,29176,761,13149
경상북도,영천시청도군,영천시,90652,62162,미래통합당,더불어민주당,37315,14918,61258,904,28490
경상북도,영천시청도군,청도군,39348,28329,미래통합당,더불어민주당,20265,5184,27832,497,11019
경상북도,포항시남구울릉군,울릉군,8608,5904,미래통합당,더불어민주당,3454,1711,5833,71,2704
경상북도,포항시남구울릉군,포항시남구,198012,130074,미래통합당,더불어민주당,71340,44257,128133,1941,67938
경상북도,포항시북구,포항시북구,229712,154613,미래통합당,더불어민주당,98905,47924,152677,1936,75099
광주광역시,광산구갑,광산구,139213,88264,더불어민주당,민생당,67482,11570,86765,1499,50949
광주광역시,광산구을,광산구,182793,117137,더불어민주당,민생당,96808,8606,115172,1965,65656
광주광역시,동구남구갑,남구,139730,94110,더불어민주당,민생당,71626,19112,92733,1377,45620
광주광역시,동구남구을,동구,128725,86577,더불어민주당,무소속,61587,12804,85210,1367,42148
광주광역시,북구갑,북구,155882,103390,더불어민주당,무소속,59011,38397,102097,1293,52492
광주광역시,북구을,북구,208908,139020,더불어민주당,민생당,108229,15281,137297,1723,69888
광주광역시,서구갑,서구,131513,85304,더불어민주당,민생당,69285,8474,84308,996,46209
광주광역시,서구을,서구,121208,81972,더불어민주당,민생당,61279,15754,80811,1161,39236
대구광역시,달서구갑,달서구,145177,96442,미래통합당,더불어민주당,54700,25523,94943,1499,48735
대구광역시,달서구병,달서구,133291,85612,미래통합당,더불어민주당,46988,23257,84216,1396,47679
대구광역시,달서구을,달서구,203446,140408,미래통합당,더불어민주당,90762,38969,138848,1560,63038
대구광역시,달성군,달성군,208115,133611,미래통합당,더불어민주당,88846,35649,131938,1673,74504
대구광역시,동구갑,동구,124323,82213,미래통합당,더불어민주당,56444,21594,81103,1110,42110
대구광역시,동구을,동구,172158,112039,미래통합당,더불어민주당,66461,33644,110154,1885,60119
대구광역시,북구갑,북구,160316,107834,미래통합당,더불어민주당,52916,27395,106214,1620,52482
대구광역시,북구을,북구,207826,139043,미래통합당,더불어민주당,84378,45891,136788,2255,68783
대구광역시,서구,서구,157355,100090,미래통합당,더불어민주당,66574,17580,98717,1373,57265
대구광역시,수성구갑,수성구,207130,155155,미래통합당,더불어민주당,92018,60462,153850,1305,51975
대구광역시,수성구을,수성구,149960,105066,무소속,미래통합당,40015,37165,103895,1171,44894
대구광역시,중구남구,남구,133305,84766,미래통합당,더불어민주당,57050,25177,83575,1191,48539
대구광역시,중구남구,중구,67769,45170,미래통합당,더불어민주당,29420,14555,44547,623,22599
대전광역시,대덕구,대덕구,151336,97617,더불어민주당,미래통합당,47652,44617,96470,1147,53719
대전광역시,동구,동구,193872,121792,더불어민주당,미래통합당,61345,57194,120248,1544,72080
대전광역시,서구갑,서구,213330,136521,더불어민주당,미래통합당,74978,57720,134880,1641,76809
대전광역시,서구을,서구,188715,124653,더불어민주당,미래통합당,70708,50140,122964,1689,64062
대전광역시,유성구갑,유성구,148801,99185,더불어민주당,미래통합당,55463,39588,98116,1069,49616
대전광역시,유성구을,유성구,134730,97283,더불어민주당,미래통합당,53785,35629,96293,990,37447
대전광역시,중구,중구,205922,133503,더불어민주당,미래통합당,66306,63498,131800,1703,72419
부산광역시,금정구,금정구,210078,144002,미래통합당,더불어민주당,77048,57459,142175,1827,66076
부산광역시,기장군,기장군,134292,86811,미래통합당,더불어민주당,42634,38154,85896,915,47481
부산광역시,남구갑,남구,120446,82729,미래통합당,더불어민주당,43805,34778,81764,965,37717
부산광역시,남구을,남구,114836,82159,더불어민주당,미래통합당,41005,39575,81196,963,32677
부산광역시,동래구,동래구,232595,159393,미래통합당,더불어민주당,81722,67430,157584,1809,73202
부산광역시,부산진구갑,부산진구,156839,108421,미래통합당,더불어민주당,52037,48287,107250,1171,48418
부산광역시,부산진구을,부산진구,158660,102833,미래통합당,더불어민주당,55754,44277,101307,1526,55827
부산광역시,북구강서구갑,북구,141852,97195,더불어민주당,미래통합당,48733,46795,96334,861,44657
부산광역시,북구강서구을,강서구,212100,147529,미래통합당,더불어민주당,76054,63146,146169,1360,64571
부산광역시,사상구,사상구,191651,129101,미래통합당,더불어민주당,66353,59346,127514,1587,62550
부산광역시,사하구갑,사하구,120263,80974,더불어민주당,미래통합당,39875,39178,79735,1239,39289
부산광역시,사하구을,사하구,157166,101631,미래통합당,더불어민주당,59042,38944,100419,1212,55535
부산광역시,서구동구,동구,80987,52770,미래통합당,더불어민주당,29040,21905,51927,843,28217
부산광역시,서구동구,서구,96522,63012,미래통합당,더불어민주당,34815,26189,62018,994,33510
부산광역시,수영구,수영구,157108,104896,미래통합당,더불어민주당,57959,42489,103619,1277,52212
부산광역시,연제구,연제구,182148,128204,미래통합당,더불어민주당,64640,60570,126863,1341,53944
부산광역시,중구영도구,영도구,104519,68143,미래통합당,더불어민주당,34224,30722,67184,959,36376
부산광역시,중구영도구,중구,38748,24717,미래통합당,더불어민주당,13212,10363,24282,435,14031
부산광역시,해운대구갑,해운대구,191197,133831,미래통합당,더불어민주당,78971,49633,132775,1056,57366
부산광역시,해운대구을,해운대구,154630,103215,미래통합당,더불어민주당,53900,46799,101945,1270,51415
서울특별시,강남구갑,강남구,167537,104485,미래통합당,더불어민주당,60324,40935,103279,1206,63052
서울특별시,강남구병,강남구,151713,109436,미래통합당,더불어민주당,70917,36423,108468,968,42277
서울특별시,강남구을,강남구,140330,102469,미래통합당,더불어민주당,51762,47157,101601,868,37861
서울특별시,강동구갑,강동구,221217,157793,더불어민주당,미래통합당,80361,74441,156033,1760,63424
서울특별시,강동구을,강동구,165610,109651,더불어민주당,미래통합당,59175,45617,108493,1158,55959
서울특별시,강북구갑,강북구,141126,87195,더불어민주당,미래통합당,49490,33840,85690,1505,53931
서울특별시,강북구을,강북구,137495,89639,더불어민주당,미래통합당,57013,30708,88458,1181,47856
서울특별시,강서구갑,강서구,173756,114516,더불어민주당,미래통합당,63397,43519,113415,1101,59240
서울특별시,강서구병,강서구,161351,108962,더불어민주당,미래통합당,64515,39355,107663,1299,52389
서울특별시,강서구을,강서구,176017,120281,더불어민주당,미래통합당,66684,50281,118757,1524,55736
서울특별시,관악구갑,관악구,243127,161860,더불어민주당,무소속,83479,50078,149259,12601,81267
서울특별시,관악구을,관악구,209866,136344,더불어민주당,미래통합당,72531,56130,134563,1781,73522
서울특별시,광진구갑,광진구,156559,106506,더불어민주당,미래통합당,56608,42822,105454,1052,50053
서울특별시,광진구을,광진구,152526,108576,더불어민주당,미래통합당,54210,51464,107618,958,43950
서울특별시,구로구갑,구로구,205756,142081,더불어민주당,미래통합당,75865,55347,140677,1404,63675
서울특별시,구로구을,구로구,146644,99398,더불어민주당,미래통합당,56065,37018,98279,1119,47246
서울특별시,금천구,금천구,207730,132177,더불어민주당,미래통합당,64735,46278,130435,1742,75553
서울특별시,노원구갑,노원구,138917,96033,더불어민주당,미래통합당,53911,36782,94941,1092,42884
서울특별시,노원구병,노원구,151435,105415,더불어민주당,미래통합당,55556,46373,104525,890,46020
서울특별시,노원구을,노원구,163736,115788,더불어민주당,미래통합당,71708,41792,114406,1382,47948
서울특별시,도봉구갑,도봉구,142625,94701,더불어민주당,미래통합당,50653,37967,93751,950,47924
서울특별시,도봉구을,도봉구,148641,98926,더불어민주당,미래통합당,51756,44554,97634,1292,49715
서울특별시,동대문구갑,동대문구,148982,99027,더불어민주당,미래통합당,51551,40874,97770,1257,49955
서울특별시,동대문구을,동대문구,156971,104468,더불어민주당,미래통합당,55230,44360,101252,3216,52503
서울특별시,동작구갑,동작구,185301,128611,더불어민주당,미래통합당,70290,54526,127122,1489,56690
서울특별시,동작구을,동작구,162038,119000,더불어민주당,미래통합당,61407,53026,117726,1274,43038
서울특별시,마포구갑,마포구,136147,96058,더불어민주당,미래통합당,53160,40775,94929,1129,40089
서울특별시,마포구을,마포구,189669,130575,더불어민주당,미래통합당,69336,47443,128984,1591,59094
서울특별시,서대문구갑,서대문구,131930,91096,더불어민주당,미래통합당,47980,37522,90105,991,40834
서울특별시,서대문구을,서대문구,141386,96528,더불어민주당,미래통합당,58328,35853,95103,1425,44858
서울특별시,서초구갑,서초구,162807,117502,미래통합당,더불어민주당,72896,42971,116442,1060,45305
서울특별시,서초구을,서초구,196164,140056,미래통합당,더불어민주당,74445,62442,138725,1331,56108
서울특별시,성북구갑,성북구,202294,138186,더불어민주당,미래통합당,82954,49727,136203,1983,64108
서울특별시,성북구을,성북구,180743,120606,더불어민주당,미래통합당,70740,45543,119172,1434,60137
서울특별시,송파구갑,송파구,159514,114985,미래통합당,더불어민주당,58318,54704,113897,1088,44529
서울특별시,송파구병,송파구,215647,151513,더불어민주당,미래통합당,78789,64869,150104,1409,64134
서울특별시,송파구을,송파구,199967,143935,미래통합당,더불어민주당,72072,65763,142829,1106,56032
서울특별시,양천구갑,양천구,206747,152176,더불어민주당,미래통합당,78196,67814,150810,1366,54571
서울특별시,양천구을,양천구,176413,117575,더불어민주당,미래통합당,66759,47897,116022,1553,58838
서울특별시,영등포구갑,영등포구,187997,130099,더불어민주당,미래통합당,72445,49292,128764,1335,57898
서울특별시,영등포구을,영등포구,139384,94810,더불어민주당,미래통합당,47075,41537,93657,1153,44574
서울특별시,용산구,용산구,203233,135043,미래통합당,더불어민주당,63891,63001,133643,1400,68190
서울특별시,은평구갑,은평구,206917,135749,더불어민주당,미래통합당,86351,45589,134310,1439,71168
서울특별시,은평구을,은평구,210129,139045,더불어민주당,미래통합당,78897,49796,137420,1625,71084
서울특별시,종로구,종로구,134516,95239,더불어민주당,미래통합당,54902,37594,94038,1201,39277
서울특별시,중구성동구갑,성동구,192161,131200,더불어민주당,미래통합당,70387,53107,129745,1455,60961
서울특별시,중구성동구을,중구,183779,124700,더불어민주당,미래통합당,64071,58300,123308,1392,59079
서울특별시,중랑구갑,중랑구,158409,96685,더불어민주당,미래통합당,55185,34670,95540,1145,61724
서울특별시,중랑구을,중랑구,192460,126399,더불어민주당,미래통합당,74131,47603,125037,1362,66061
세종특별자치시,세종특별자치시갑,세종특별자치시,142033,100062,더불어민주당,미래통합당,55947,32496,99097,965,41971
세종특별자치시,세종특별자치시을,세종특별자치시,121305,80339,더불어민주당,미래통합당,46002,31495,79362,977,40966
울산광역시,남구갑,남구,147996,104653,미래통합당,더불어민주당,55252,44773,103451,1202,43343
울산광역시,남구을,남구,126872,84890,미래통합당,더불어민주당,48933,33565,83674,1216,41982
울산광역시,동구,동구,130353,89256,미래통합당,민생당,33845,29889,88218,1038,41097
울산광역시,북구,북구,173616,118334,더불어민주당,미래통합당,54215,47836,116978,1356,55282
울산광역시,울주군,울주군,186083,127265,미래통합당,더불어민주당,66317,54563,125721,1544,58818
울산광역시,중구,중구,188368,129930,미래통합당,더불어민주당,69359,44050,128331,1599,58438
인천광역시,계양구갑,계양구,118127,74341,더불어민주당,미래통합당,44469,26890,73518,823,43786
인천광역시,계양구을,계양구,142502,89298,더불어민주당,미래통합당,51821,34222,88321,977,53204
인천광역시,남동구갑,남동구,219206,135352,더불어민주당,미래통합당,72773,59466,133806,1546,83854
인천광역시,남동구을,남동구,228545,145945,더불어민주당,미래통합당,78795,54264,144379,1566,82600
인천광역시,동구미추홀구갑,동구,55752,36365,더불어민주당,미래통합당,17063,15767,35902,463,19387
인천광역시,동구미추홀구갑,미추홀구,166276,95532,더불어민주당,미래통합당,46417,39116,94242,1290,70744
인천광역시,동구미추홀구을,미추홀구,187260,115979,무소속,더불어민주당,46493,46322,114528,1451,71281
인천광역시,부평구갑,부평구,232384,138577,더불어민주당,미래통합당,77460,57148,136646,1931,93807
인천광역시,부평구을,부평구,204936,133838,더불어민주당,미래통합당,74264,47789,132308,1530,71098
인천광역시,서구갑,서구,225827,144188,더불어민주당,미래통합당,76072,60733,142898,1290,81639
인천광역시,서구을,서구,221393,137595,더불어민주당,미래통합당,83671,50763,135733,1862,83798
인천광역시,연수구갑,연수구,124956,80926,더불어민주당,미래통합당,45479,33646,79957,969,44030
인천광역시,연수구을,연수구,176522,127166,더불어민주당,미래통합당,52806,49913,126375,791,49356
인천광역시,중구강화군옹진군,강화군,62017,41162,미래통합당,더불어민주당,24668,14968,40510,652,20855
인천광역시,중구강화군옹진군,옹진군,18582,13651,미래통합당,더불어민주당,7718,5289,13317,334,4931
인천광역시,중구강화군옹진군,중구,115214,71230,더불어민주당,미래통합당,38948,30098,70434,796,43984
전라남도,고흥군보성군장흥군강진군,강진군,31293,22651,더불어민주당,민생당,12105,9519,22155,496,8642
전라남도,고흥군보성군장흥군강진군,고흥군,58877,44680,더불어민주당,민생당,27293,14919,43542,1138,14197
전라남도,고흥군보성군장흥군강진군,보성군,37347,26471,더불어민주당,민생당,17025,8056,25897,574,10876
전라남도,고흥군보성군장흥군강진군,장흥군,34098,24786,더불어민주당,민생당,16349,7255,24253,533,9312
전라남도,나주시화순군,나주시,96891,62737,더불어민주당,민생당,45957,13860,60797,1940,34154
전라남도,나주시화순군,화순군,54477,36078,더불어민주당,민생당,29629,4891,35118,960,18399
전라남도,담양군함평군영광군장성군,담양군,41649,28735,더불어민주당,무소속,25503,1253,28136,599,12914
전라남도,담양군함평군영광군장성군,영광군,46569,30159,더불어민주당,무소속,23227,4055,29521,638,16410
전라남도,담양군함평군영광군장성군,장성군,39878,26662,더불어민주당,무소속,22582,2081,26086,576,13216
전라남도,담양군함평군영광군장성군,함평군,29567,22495,더불어민주당,무소속,15003,4900,21573,922,7072
전라남도,목포시,목포시,189615,128688,더불어민주당,민생당,62065,47528,127269,1419,60927
전라남도,순천시광양시곡성군구례군갑,순천시,192827,135649,더불어민주당,무소속,78480,42476,134008,1641,57178
전라남도,순천시광양시곡성군구례군을,곡성군,25904,18214,더불어민주당,무소속,13635,2081,17880,334,7690
전라남도,순천시광양시곡성군구례군을,광양시,166390,109721,더불어민주당,무소속,67346,28941,108356,1365,56669
전라남도,순천시광양시곡성군구례군을,구례군,23328,16850,더불어민주당,무소속,11461,3362,16528,322,6478
전라남도,여수시갑,여수시,118828,76613,더불어민주당,무소속,48410,23128,75119,1494,42215
전라남도,여수시을,여수시,120540,78442,더불어민주당,무소속,55273,15302,77217,1225,42098
전라남도,영암군무안군신안군,무안군,67280,44668,더불어민주당,민생당,32786,9469,43696,972,22612
전라남도,영암군무안군신안군,신안군,36717,24580,더불어민주당,민생당,18748,4419,23966,614,12137
전라남도,영암군무안군신안군,영암군,46989,30009,더불어민주당,민생당,23127,4947,29343,666,16980
전라남도,해남군완도군진도군,완도군,44311,30967,더불어민주당,민생당,22485,7326,30224,743,13344
전라남도,해남군완도군진도군,진도군,27067,18107,더불어민주당,민생당,11688,5535,17626,481,8960
전라남도,해남군완도군진도군,해남군,61477,41324,더불어민주당,민생당,25440,14429,40457,867,20153
전라북도,군산시,군산시,225593,151665,더불어민주당,무소속,88857,55082,149972,1693,73928
전라북도,김제시부안군,김제시,74066,48983,더불어민주당,무소속,31224,15213,48061,922,25083
전라북도,김제시부안군,부안군,47303,30545,더불어민주당,무소속,20757,5949,29895,650,16758
전라북도,남원시임실군순창군,남원시,70326,52037,무소속,더불어민주당,27912,21190,51163,874,18289
전라북도,남원시임실군순창군,순창군,24821,18579,더불어민주당,무소속,10076,7368,18177,402,6242
전라북도,남원시임실군순창군,임실군,25325,18127,더불어민주당,무소속,9182,7838,17779,348,7198
전라북도,완주군진안군무주군장수군,무주군,21521,15675,더불어민주당,무소속,8354,6118,15374,301,5846
전라북도,완주군진안군무주군장수군,완주군,78113,54010,더불어민주당,무소속,28573,22440,53188,822,24103
전라북도,완주군진안군무주군장수군,장수군,19781,14561,더불어민주당,무소속,8483,5155,14269,292,5220
전라북도,완주군진안군무주군장수군,진안군,23024,17901,더불어민주당,무소속,11588,5023,17350,551,5123
전라북도,익산시갑,익산시,118769,75250,더불어민주당,민생당,59043,7057,74139,1111,43519
전라북도,익산시을,익산시,124676,79688,더불어민주당,민생당,56982,12302,78492,1196,44988
전라북도,전주시갑,전주시완산구,145862,93635,더불어민주당,무소속,67849,15384,92220,1415,52227
전라북도,전주시병,전주시덕진구,232210,158408,더불어민주당,민생당,104039,50022,156093,2315,73802
전라북도,전주시을,전주시완산구,165905,109358,더불어민주당,무소속,67568,21697,108038,1320,56547
전라북도,정읍시고창군,고창군,49131,32966,더불어민주당,민생당,24078,7995,32073,893,16165
전라북도,정읍시고창군,정읍시,95608,62486,더불어민주당,민생당,41004,20191,61195,1291,33122
제주특별자치도,서귀포시,서귀포시,152676,97530,더불어민주당,미래통합당,53345,41689,96143,1387,55146
제주특별자치도,제주시갑,제주시,208660,128031,더불어민주당,미래통합당,61626,46909,126540,1491,80629
제주특별자치도,제주시을,제주시,191862,122883,더불어민주당,미래통합당,67206,49862,121412,1471,68979
충청남도,공주시부여군청양군,공주시,93319,61117,더불어민주당,미래통합당,29315,28128,60292,825,32202
충청남도,공주시부여군청양군,부여군,59570,39362,미래통합당,더불어민주당,19490,17071,38744,618,20208
충청남도,공주시부여군청양군,청양군,28453,19384,미래통합당,더불어민주당,9869,8477,19123,261,9069
충청남도,논산시계룡시금산군,계룡시,33571,24097,더불어민주당,미래통합당,12384,10590,23793,304,9474
충청남도,논산시계룡시금산군,금산군,45691,28694,미래통합당,더불어민주당,14284,13004,28093,601,16997
충청남도,논산시계룡시금산군,논산시,102893,63408,더불어민주당,미래통합당,32931,28110,62440,968,39485
충청남도,당진시,당진시,137609,81858,더불어민주당,미래통합당,38535,24457,80848,1010,55751
충청남도,보령시서천군,보령시,87911,59870,미래통합당,더불어민주당,32453,26533,58986,884,28041
충청남도,보령시서천군,서천군,47346,32803,더불어민주당,미래통합당,18295,13952,32247,556,14543
충청남도,서산시태안군,서산시,145216,91889,미래통합당,더불어민주당,46471,41193,90723,1166,53327
충청남도,서산시태안군,태안군,55645,36795,미래통합당,더불어민주당,20446,14934,36259,536,18850
충청남도,아산시갑,아산시,125840,77591,미래통합당,더불어민주당,38167,37603,76596,995,48249
충청남도,아산시을,아산시,126172,76889,더불어민주당,미래통합당,45338,30584,75922,967,49283
충청남도,천안시갑,천안시동남구,168135,94976,더불어민주당,미래통합당,45999,44671,93216,1760,73159
충청남도,천안시병,천안시동남구,147013,91005,더불어민주당,미래통합당,43118,36854,89793,1212,56008
충청남도,천안시을,천안시서북구,221716,134675,더불어민주당,미래통합당,78223,46389,132946,1729,87041
충청남도,홍성군예산군,예산군,70656,44829,미래통합당,더불어민주당,24796,18789,44207,622,25827
충청남도,홍성군예산군,홍성군,84568,52895,미래통합당,더불어민주당,27201,24080,52168,727,31673
충청북도,보은군옥천군영동군괴산군,괴산군,35083,23735,미래통합당,더불어민주당,13428,9453,23325,410,11348
충청북도,보은군옥천군영동군괴산군,보은군,29585,20913,미래통합당,더불어민주당,11693,8239,20340,573,8672
충청북도,보은군옥천군영동군괴산군,영동군,43142,29587,미래통합당,더불어민주당,16393,12288,29065,522,13555
충청북도,보은군옥천군영동군괴산군,옥천군,45082,30588,미래통합당,더불어민주당,16976,12633,30095,493,14494
충청북도,제천시단양군,단양군,26696,18583,미래통합당,더불어민주당,10704,7427,18341,242,8113
충청북도,제천시단양군,제천시,115635,77243,미래통합당,더불어민주당,40470,34762,76247,996,38392
충청북도,증평군진천군음성군,음성군,82222,48328,미래통합당,더불어민주당,24393,22572,47710,618,33894
충청북도,증평군진천군음성군,증평군,31138,18927,더불어민주당,미래통합당,9663,8780,18673,254,12211
충청북도,증평군진천군음성군,진천군,67443,40900,더불어민주당,미래통합당,21891,17908,40400,500,26543
충청북도,청주시상당구,청주시상당구,151173,98093,더불어민주당,미래통합당,45707,42682,97052,1041,53080
충청북도,청주시서원구,청주시서원구,169388,109940,더불어민주당,미래통합당,54118,50784,108540,1400,59448
충청북도,청주시청원구,청주시청원구,158171,97694,더불어민주당,미래통합당,51028,42776,96290,1404,60477
충청북도,청주시흥덕구,청주시흥덕구,218211,135919,더불어민주당,미래통합당,74900,57656,134211,1708,82292
충청북도,충주시,충주시,180642,115405,미래통합당,더불어민주당,59667,51290,114186,1219,65237
